5 7
*******
*     *
* *** *
*     *
*******
