o o o o o o o o o o o o o o o
 oooooooooooooooooooooooooooo
oo                          oo
 o                          o 
oo                          oo
 o     oooo     oooooo      o 
oo     oo o     oo o o      oo
 o     o oo     oooooo      o 
oo     oo o                 oo
 o     o oo                 o 
oo     oooo                 oo
 o                          o 
oo              oooooo      oo
 o              o o oo      o 
oo              oo o o      oo
oo     oooo     oooooo      oo
 o     o oo                 o 
oo     oo o                 oo
 o     o oo                 o 
oo     oo o                 oo
 o     o oo     oooooo      o 
 o     o oo     oo o o      o 
oo     oooo     oooooo      oo
 o                          o 
oo                          oo
 o                          o 
oooooooooooooooooooooooooooooo
  o o o o o o o o o o o o o o