****************************
*                          *
*    ooooooooooooooooo     *
*   o      o          o    *
*  o  ****  o  ******  o   *
*  o  *  *  o  *    *  o   *
*  o  *  *  o  ******  o   *
*  o  *  *  o          o   *
*  o  *  *  o          o   *
*  o  ****  oooooooooooo   *
*  o        o          o   *
*  oooooooooo  ******  o   *
*  o        o  *    *  o   *
*  o        o  *    *  o   *
*  o  ****  o  ******  o   *
*  o  *  *  o          o   *
*  o  *  *  o          o   *
*  o  *  *  oooooooooooo   *
*  o  *  *  o          o   *
*  o  *  *  o  ******  o   *
*  o  *  *  o  *    *  o   *
*  o  ****  o  ******  o   *
*   o       o         o    *
*    ooooooooooooooooo     *
*                          *
****************************